0   0   0   0   0   0   0   0   0   0   0   0   0   0   0   0   0   0   0   0   0   0   0   0   0   0   0   0   0   0   0   0   0   0   0   0   0   0   0   0   0   0   0   0   0   0   0   0   0   0   0   0   0   0   0   0   0   0   0   0   0   0   0   0   0   0   0   0   0   0   0   0   0   0   0   0   0   0   0   0   0   0   0   0   0   0   0   0   0   0   0   0   0   0   0   0   0   0   0   0   0  0  0 0 0 0 0  0 0 0  0 0 0  0 0 0 0 0 0  0 0 0  0  0  0 0 0 0 0  0  0  0  0 0 0 0 0 0 0 0 0 0 0 0 0 0 0 0 0 0 0 0 0 0 0 0 0 0 0 0 0 0 0 0  0  0 0 0 0  0  0  0   0   0   0   0   0   0   0   0   0   0   0   0   0   0   0   0   0   0   0   0   0   0   0   0   0   0   0   0   0   0   0   0   0   0   0   0   0   0   0   0   0   0   0   0   0   0   0   0   0   0   0   0   0   0   0   0   0   0   0   0   0   0   0   0   0   0   0   0   0   0   0   0   0   0   0   0   0   0   0   0   0   0   0   0   0   0   0   0 
0   0   0   0   0   0   0   0   0   0   0   0   0   0   0   0   0   0   0   0   0   0   0   0   0   0   0   0   0   0   0   0   0   0   0   0   0   0   0   0   0   0   0   0   0   0   0   0   0   0   0   0   0   0   0   0   0   0   0   0   0   0   0   0   0   0   0   0   0   0   0   0   0   0   0   0   0   0   0   0   0   0   0   0   0   0   0   0   0   0   0   0   0   0   0   0   0   0   0   0   0  0  0 0 0 0 0  0 0 0  0 0 0  0 0 0 0 0 0  0 0 0  0  0  0 0 0 0 0  0  0  0  0 0 0 0 0 0 0 0 0 0 0 0 0 0 0 0 0 0 0 0 0 0 0 0 0 0 0 0 0 0 0 0  0  0 0 0 0  0  0  0   0   0   0   0   0   0   0   0   0   0   0   0   0   0   0   0   0   0   0   0   0   0   0   0   0   0   0   0   0   0   0   0   0   0   0   0   0   0   0   0   0   0   0   0   0   0   0   0   0   0   0   0   0   0   0   0   0   0   0   0   0   0   0   0   0   0   0   0   0   0   0   0   0   0   0   0   0   0   0   0   0   0   0   0   0   0   0   0 
0   0   0   0   0   0   0   0   0   0   0   0   0   0   0   0   0   0   0   0   0   0   0   0   0   0   0   0   0   0   0   0   0   0   0   0   0   0   0   0   0   0   0   0   0   0   0   0   0   0   0   0   0   0   0   0   0   0   0   0   0   0   0   0   0   0   0   0   0   0   0   0   0   0   0   0   0   0   0   0   0   0   0   0   0   0   0   0   0   0   0   0   0   0   0   0   0   0   0   0   0  0  0 0 0 0 0  0 0 0  0 0 0  0 0 0 0 0 0  0 0 0  0  0  0 0 0 0 0  0  0  0  0 0 0 0 0 0 0 0 0 0 0 0 0 0 0 0 0 0 0 0 0 0 0 0 0 0 0 0 0 0 0 0  0  0 0 0 0  0  0  0   0   0   0   0   0   0   0   0   0   0   0   0   0   0   0   0   0   0   0   0   0   0   0   0   0   0   0   0   0   0   0   0   0   0   0   0   0   0   0   0   0   0   0   0   0   0   0   0   0   0   0   0   0   0   0   0   0   0   0   0   0   0   0   0   0   0   0   0   11  0   0   0   11  11  11  11  11  11  11  0   0   0   0   28  29  0   0   0 
0   0   0   0   0   0   0   0   0   0   0   0   0   0   0   0   0   0   0   0   0   0   0   0   0   0   0   0   0   0   0   0   0   0   0   0   0   0   0   0   0   0   0   0   0   0   0   0   0   0   0   0   0   0   0   0   0   0   0   0   0   0   0   0   0   0   0   0   0   0   0   0   0   0   0   0   0   0   0   0   0   0   0   0   0   0   0   0   0   0   0   0   0   0   0   0   0   0   0   0   0  0  0 0 0 0 0  0 0 0  0 0 0  0 0 0 0 0 0  0 0 0  0  0  0 0 0 0 0  0  0  0  0 0 0 0 0 0 0 0 0 0 0 0 0 0 0 0 0 0 0 0 0 0 0 0 0 0 0 0 0 0 0 0  0  0 0 0 0  0  0  0   0   0   0   0   0   0   0   0   0   0   0   0   0   0   0   0   0   0   0   0   0   0   0   0   0   0   0   0   0   0   73  0   0   0   0   0   0   0   0   0   0   0   0   0   0   0   0   0   0   0   0   0   0   0   0   0   0   0   0   0   0   0   0   0   0   0   0   0   11  0   0   0   0   0   0   0   0   0   0   0   0   0   0   28  29  0   0   0 
0   0   0   0   0   0   0   0   0   0   0   0   0   0   0   0   0   0   0   0   0   0   0   0   0   0   0   0   0   0   0   0   0   0   0   0   0   0   0   0   0   0   0   0   0   0   0   0   0   0   0   0   0   0   0   0   0   0   0   0   0   0   0   0   0   0   0   0   0   0   0   0   0   0   0   0   0   0   0   0   0   0   0   0   0   0   0   0   0   0   0   0   0   0   0   0   0   0   0   0   0  0  0 0 0 0 0  0 0 0  0 0 0  0 0 0 0 0 0  0 0 0  0  0  0 0 0 0 0  0  0  0  0 0 0 0 0 0 0 0 0 0 0 0 0 0 0 0 0 0 0 0 0 0 0 0 0 0 0 0 0 0 0 0  0  0 0 0 0  0  0  0   0   0   0   0   0   0   0   0   0   0   0   0   0   0   0   0   0   0   0   0   0   0   0   0   0   0   0   0   0   0   73  0   0   0   0   0   0   0   0   0   0   0   0   0   0   0   0   0   0   0   0   0   0   0   0   0   0   0   0   0   0   0   0   0   0   0   0   0   11  0   0   0   0   0   0   0   0   0   0   0   0   0   0   28  29  0   0   0 
0   0   0   0   0   0   0   0   0   0   0   0   0   0   0   0   0   0   0   0   0   0   13  0   0   0   0   0   0   0   0   0   0   0   0   0   0   0   0   0   0   0   0   0   0   0   0   0   0   0   0   0   0   0   0   0   0   0   0   0   0   0   0   0   0   0   0   0   0   0   0   0   0   0   0   0   0   0   0   0   10  10  10  10  10  10  10  10  0   0   0   10  10  10  13  0   0   0   0   0   0  0  0 0 0 0 0  0 0 13 0 0 0  0 0 0 0 0 0  0 0 10 10 10 0 0 0 0 10 13 13 10 0 0 0 0 0 0 0 0 0 0 0 0 0 0 0 0 0 0 0 0 0 0 0 0 0 0 0 0 0 0 0 0  0  0 0 0 0  0  0  0   0   0   0   0   0   0   0   0   0   0   0   0   0   0   0   0   7   7   0   0   0   0   0   0   0   0   0   0   0   0   73  0   0   0   0   0   0   0   0   0   0   0   0   0   0   0   0   0   0   0   0   0   0   0   0   0   0   0   0   0   0   0   0   0   0   0   0   0   11  0   0   0   71  71  71  71  71  71  71  0   0   0   0   28  29  0   0   0 
0   0   0   0   0   0   0   0   0   0   0   0   0   0   0   0   0   0   0   0   0   0   0   0   0   0   0   0   0   0   0   0   0   0   0   0   0   0   0   0   0   0   0   0   0   0   0   0   0   0   0   0   0   0   0   0   0   0   0   0   0   0   0   0   0   0   0   0   0   0   0   0   0   0   0   0   0   0   0   0   0   0   0   0   0   0   0   0   0   0   0   0   0   0   0   0   0   0   0   0   0  0  0 0 0 0 0  0 0 0  0 0 0  0 0 0 0 0 0  0 0 0  0  0  0 0 0 0 0  0  0  0  0 0 0 0 0 0 0 0 0 0 0 0 0 0 0 0 0 0 0 0 0 0 0 0 0 0 0 0 0 0 0 0  0  0 0 0 0  0  0  0   0   0   0   0   0   0   0   0   0   0   0   0   0   0   0   7   7   7   0   0   0   0   0   0   0   0   0   0   0   0   73  0   0   0   0   0   0   0   0   0   0   0   0   0   0   0   0   0   0   0   0   0   0   0   0   0   0   0   0   0   0   0   0   0   0   0   0   0   11  0   0   0   0   0   0   0   0   0   0   0   0   0   0   28  29  0   0   0 
0   0   0   0   0   0   0   0   0   0   0   0   0   0   0   0   0   0   0   0   0   0   0   0   0   0   0   0   0   0   0   0   0   0   0   0   0   0   0   0   0   0   0   0   0   0   0   0   0   0   0   0   0   0   0   0   0   0   0   0   0   0   0   0   0   0   0   0   0   0   0   0   0   0   0   0   0   0   0   0   0   0   0   0   0   0   0   0   0   0   0   0   0   0   0   0   0   0   0   0   0  0  0 0 0 0 0  0 0 0  0 0 0  0 0 0 0 0 0  0 0 0  0  0  0 0 0 0 0  0  0  0  0 0 0 0 0 0 0 0 0 0 0 0 0 0 0 0 0 0 0 0 0 0 0 0 0 0 0 0 0 0 0 0  0  0 0 0 0  0  0  0   0   0   0   0   0   0   0   0   0   0   0   0   0   0   7   7   7   7   0   0   0   0   0   0   0   0   0   0   0   0   73  0   0   0   0   0   0   0   0   0   0   0   0   0   0   0   0   0   0   0   0   0   0   0   0   0   0   0   0   0   0   0   0   0   0   0   0   0   11  0   0   0   71  71  71  71  71  71  71  0   0   0   0   28  29  0   0   0 
0   0   0   0   0   0   0   0   0   0   0   0   0   0   0   0   0   0   0   0   0   0   0   0   0   0   0   0   0   0   0   0   0   0   0   0   0   0   0   0   0   0   0   0   0   0   0   0   0   0   0   0   0   0   0   0   0   0   0   0   0   0   0   0   0   0   0   0   0   0   0   0   0   0   0   0   0   0   0   0   0   0   0   0   0   0   0   0   0   0   0   0   0   0   0   0   0   0   0   0   0  0  0 0 0 0 0  0 0 0  0 0 0  0 0 0 0 0 0  0 0 0  0  0  0 0 0 0 0  0  0  0  0 0 0 0 0 0 0 0 0 0 0 0 0 0 0 0 0 0 0 0 0 0 0 0 0 0 0 0 0 0 0 0  0  0 0 0 0  0  0  0   0   0   0   0   0   0   0   0   0   0   0   0   0   7   7   7   7   7   0   0   0   0   0   0   0   0   0   0   0   0   73  0   0   0   0   83  83  83  0   0   0   0   0   0   0   0   0   0   0   0   0   0   0   0   0   0   0   0   0   0   0   0   0   0   0   0   0   0   11  0   0   0   0   0   0   0   0   0   0   0   0   0   0   28  29  0   0   0 
0   0   0   0   0   0   0   0   0   0   0   0   0   0   0   0   13  0   0   0   10  13  10  13  10  0   0   0   0   0   0   0   0   0   0   0   0   0   0   0   0   0   0   0   0   0   20  21  0   0   0   0   0   0   0   0   0   20  21  0   0   0   0   0   0   0   0   0   0   0   0   0   0   0   0   0   0   10  13  10  0   0   0   0   0   0   0   0   0   0   0   0   0   0   10  0   0   0   0   0   10 10 0 0 0 0 13 0 0 13 0 0 13 0 0 0 0 0 10 0 0 0  0  0  0 0 0 0 0  10 0  0  0 0 0 0 0 7 0 0 7 0 0 0 0 0 0 0 0 0 0 7 7 0 0 7 0 0 0 0 0 0 0 0  0  0 0 0 10 10 13 10  0   0   0   0   0   0   0   0   0   0   0   0   7   7   7   7   7   7   0   0   0   0   0   0   0   0   0   0   0   0   73  0   0   0   0   80  77  81  0   0   0   0   0   0   0   0   0   0   0   0   0   0   0   0   0   0   0   0   0   0   0   0   0   0   0   0   0   0   11  0   0   0   71  71  71  71  71  71  71  0   0   0   0   28  29  0   0   0 
0   0   0   0   0   0   0   0   0   0   0   0   0   0   0   0   0   0   0   0   0   0   0   0   0   0   0   0   0   0   0   0   0   0   0   0   0   0   20  21  0   0   0   0   0   0   18  19  0   0   0   0   0   0   0   0   0   18  19  0   0   0   0   0   0   0   0   0   0   0   0   0   0   0   0   0   0   0   0   0   0   0   0   0   0   0   0   0   0   0   0   0   0   0   0   0   0   0   0   0   0  0  0 0 0 0 0  0 0 0  0 0 0  0 0 0 0 0 0  0 0 0  0  0  0 0 0 0 0  0  0  0  0 0 0 0 7 7 0 0 7 7 0 0 0 0 0 0 0 0 7 7 7 0 0 7 7 0 0 0 0 0 0 0  0  0 0 0 0  0  0  0   0   0   0   0   0   0   0   0   0   0   0   7   7   7   7   7   7   7   0   0   0   0   0   0   0   0   0   0   0   0   73  0   0   0   83  82  82  82  83  0   0   0   0   0   0   0   0   0   0   0   0   0   0   0   0   0   0   0   0   0   0   0   0   0   0   0   0   0   11  0   0   0   11  11  11  11  11  11  11  0   0   0   0   28  29  0   0   0 
0   0   0   0   0   0   0   0   0   0   0   0   0   0   0   0   0   0   0   0   0   0   0   0   0   0   0   0   20  21  0   0   0   0   0   0   0   0   18  19  0   0   0   0   0   0   18  19  0   0   0   0   0   0   0   0   0   18  19  0   0   0   0   0   0   0   0   0   0   0   0   0   0   0   0   0   0   0   0   0   0   0   0   0   0   0   0   0   0   0   0   0   0   0   0   0   0   0   0   0   0  0  0 0 0 0 0  0 0 0  0 0 0  0 0 0 0 0 0  0 0 0  0  0  0 0 0 0 0  0  0  0  0 0 0 7 7 7 0 0 7 7 7 0 0 0 0 0 0 7 7 7 7 0 0 7 7 7 0 0 0 0 0 20 21 0 0 0 0  0  0  0   0   0   0   0   0   0   0   20  21  0   7   7   7   7   7   7   7   7   0   0   0   0   0   0   0   0   0   0   0   0   73  0   0   0   77  77  79  77  77  0   0   0   0   0   0   0   0   0   0   0   0   0   0   0   0   0   0   0   0   0   0   0   0   0   0   0   0   0   11  0   0   0   11  11  11  11  11  11  11  0   0   33  35  27  29  0   0   0 
0   0   0   0   0   0   0   0   0   0   0   0   0   0   0   0   0   0   0   0   0   0   0   0   0   0   0   0   18  19  0   0   0   0   0   0   0   0   18  19  0   0   0   0   0   0   18  19  0   0   0   0   0   0   0   0   0   18  19  0   0   0   0   0   0   0   0   0   0   0   0   0   0   0   0   0   0   0   0   0   0   0   0   0   0   0   0   0   0   0   0   0   0   0   0   0   0   0   0   0   0  0  0 0 0 0 0  0 0 0  0 0 0  0 0 0 0 0 0  0 0 0  0  0  0 0 0 0 0  0  0  0  0 0 7 7 7 7 0 0 7 7 7 7 0 0 0 0 7 7 7 7 7 0 0 7 7 7 7 0 0 0 0 18 19 0 0 0 0  0  0  0   0   0   0   0   0   0   0   18  19  7   7   7   7   7   7   7   7   7   0   0   0   0   0   0   0   0   0   0   0   0   7   0   0   0   77  77  78  77  77  0   0   0   0   0   0   0   0   0   0   0   0   0   0   0   0   0   0   0   0   0   0   0   0   0   0   0   0   0   11  0   0   0   11  11  11  11  11  11  11  0   0   32  34  26  29  0   0   0 
1   1   1   1   1   1   1   1   1   1   1   1   1   1   1   1   1   1   1   1   1   1   1   1   1   1   1   1   1   1   1   1   1   1   1   1   1   1   1   1   1   1   1   1   1   1   1   1   1   1   1   1   1   1   1   1   1   1   1   1   1   1   1   1   1   1   1   1   1   0   0   1   1   1   1   1   1   1   1   1   1   1   1   1   1   1   0   0   0   1   1   1   1   1   1   1   1   1   1   1   1  1  1 1 1 1 1  1 1 1  1 1 1  1 1 1 1 1 1  1 1 1  1  1  1 1 1 1 1  1  1  1  1 1 1 1 1 1 1 1 1 1 1 1 1 1 1 1 1 1 1 1 1 0 0 1 1 1 1 1 1 1 1 1  1  1 1 1 1  1  1  1   1   1   1   1   1   1   1   1   1   1   1   1   1   1   1   1   1   1   1   1   1   1   1   1   1   1   1   1   1   1   1   1   1   1   1   1   1   1   1   1   1   1   1   1   1   1   1   1   1   1   1   1   1   1   1   1   1   1   1   1   1   1   1   1   1   1   1   1   2   2   2   2   2   2   2   2   2   2   2   2   2   2   2   2   2   0   0   0 
1   1   1   1   1   1   1   1   1   1   1   1   1   1   1   1   1   1   1   1   1   1   1   1   1   1   1   1   1   1   1   1   1   1   1   1   1   1   1   1   1   1   1   1   1   1   1   1   1   1   1   1   1   1   1   1   1   1   1   1   1   1   1   1   1   1   1   1   1   0   0   1   1   1   1   1   1   1   1   1   1   1   1   1   1   1   0   0   0   1   1   1   1   1   1   1   1   1   1   1   1  1  1 1 1 1 1  1 1 1  1 1 1  1 1 1 1 1 1  1 1 1  1  1  1 1 1 1 1  1  1  1  1 1 1 1 1 1 1 1 1 1 1 1 1 1 1 1 1 1 1 1 1 0 0 1 1 1 1 1 1 1 1 1  1  1 1 1 1  1  1  1   1   1   1   1   1   1   1   1   1   1   1   1   1   1   1   1   1   1   1   1   1   1   1   1   1   1   1   1   1   1   1   1   1   1   1   1   1   1   1   1   1   1   1   1   1   1   1   1   1   1   1   1   1   1   1   1   1   1   1   1   1   1   1   1   1   1   1   1   2   2   2   2   2   2   2   2   2   2   2   2   2   2   2   2   2   0   0   0 