0   0   0   0   0   0   0   0   0   0   0   0   0   0   0   0   0   0   0   0   0   0   0   0   0   0   0   0   0   0   0   0   0   0   0   0   0   0   0   0   0   0   0   0   0   0   0   0   0   0   0   0   0   0   0   0   0   0   0   0   0   0   0   0   0   0   0   0   0   0   0   0   0   0   0   0   0   0   0   0   0   0   0   0   0   0   0   0   0   0   0   0   0   0   0   0   0   0   0   0   0   0   0   0   0   0   0   0   0   0   0   0   0   0   0   0   0   0   0   0   0   0   0   0   0   0   0   0   0   0   0   0   0   0   0   0   0   0   0   0   0   0   0   0   0   0   0   0   0   0   0   0   0   0   0   0   0   0   0   0   0   0   0   0   0   0   0   0   0   0   0 
0   0   0   0   0   0   0   0   0   0   0   0   0   0   0   0   0   0   0   0   0   0   0   0   0   0   0   0   0   0   0   0   0   0   0   0   0   0   0   0   0   0   0   0   0   0   0   0   0   0   0   0   0   0   0   0   0   0   0   0   0   0   0   0   0   0   0   0   0   0   0   0   0   0   0   0   0   0   0   0   0   0   0   0   0   0   0   0   0   0   0   0   0   0   0   0   0   0   0   0   0   0   0   0   0   0   0   0   0   0   0   0   0   0   0   0   0   0   0   0   0   0   0   0   0   0   0   0   0   0   0   0   0   0   0   0   0   0   0   0   0   0   0   0   0   0   0   0   0   0   0   0   0   0   0   0   0   0   0   0   0   0   0   0   0   0   0   0   0   0   0 
0   0   0   0   0   0   0   0   0   0   0   0   0   0   0   0   0   0   0   0   0   0   0   0   0   0   0   0   0   0   0   0   0   0   0   0   0   0   0   0   0   0   0   13  0   0   0   0   0   119 121 121 121 121 121 121 120 0   0   0   0   0   0   0   0   0   0   0   0   0   70  70  70  0   0   0   0   0   0   0   0   119 121 121 121 121 121 121 121 120 0   0   119 121 121 121 121 120 0   0   0   0   0   119 121 121 121 121 121 120 0   0   0   0   0   0   0   0   0   0   0   0   0   0   0   0   0   0   0   0   0   0   0   0   0   0   0   0   0   0   0   0   0   0   0   0   0   74  0   0   0   0   0   83  83  83  0   0   0   0   0   0   0   0   0   0   0   0   0   0   0 
0   0   0   0   0   0   0   0   0   0   0   0   0   0   0   0   0   0   0   0   0   0   0   0   0   0   0   0   0   0   0   0   0   0   0   0   0   0   0   0   0   0   0   0   0   0   0   0   0   0   0   0   0   0   0   0   0   70  0   0   0   0   0   0   0   0   0   0   0   0   98  99  100 0   0   0   0   0   0   0   0   0   0   0   0   0   0   0   0   0   0   0   0   0   0   0   0   0   0   0   0   0   0   0   0   0   0   0   0   0   0   0   0   0   0   0   0   0   0   0   0   0   0   0   0   0   0   0   0   0   0   0   0   0   0   0   0   0   0   0   0   0   0   0   0   0   0   73  0   0   0   0   0   80  77  81  0   0   0   0   0   0   0   0   0   0   0   0   0   0   0 
0   0   0   0   0   0   0   0   0   0   0   0   0   0   0   0   0   0   0   0   70  70  70  0   0   0   0   0   0   0   0   0   98  99  100 0   0   0   0   0   0   0   0   0   0   0   0   0   0   0   0   0   0   0   0   0   0   0   0   0   0   0   0   0   0   0   0   0   0   0   0   92  0   0   0   0   0   0   0   0   0   0   0   0   0   0   0   0   0   0   0   0   0   0   0   0   0   0   0   0   0   0   0   0   70  0   0   0   0   0   0   0   0   0   0   0   0   0   0   0   0   0   0   0   0   0   0   0   0   0   0   0   0   0   0   0   0   0   0   0   0   0   0   0   0   0   0   73  0   0   0   0   83  82  82  82  83  0   0   0   0   0   0   0   0   0   0   0   0   0   0 
0   0   0   0   0   0   0   0   0   0   0   0   0   0   0   0   0   0   0   98  99  99  99  100 0   0   0   0   0   0   0   0   0   92  0   0   0   0   0   98  99  99  99  100 0   0   0   0   0   0   0   0   0   0   0   0   0   0   0   0   0   0   0   0   0   0   0   0   0   0   0   93  0   0   98  99  99  99  100 0   0   0   0   0   0   0   0   0   0   0   0   0   0   0   0   0   0   0   0   0   0   0   0   0   0   0   0   0   0   0   0   0   0   0   0   0   0   0   0   0   0   0   0   0   0   0   0   0   0   0   0   0   0   0   0   0   0   0   0   0   0   0   0   0   0   0   0   73  0   0   0   0   77  77  79  77  77  0   0   0   0   0   0   0   0   0   0   0   0   0   0 
0   0   0   0   0   0   0   0   0   0   0   0   0   0   0   0   0   0   0   0   0   92  0   0   0   0   0   0   0   0   0   0   0   93  0   0   0   0   0   0   0   92  0   0   0   0   0   0   0   0   0   0   0   0   0   0   0   0   0   0   0   0   0   0   0   0   0   70  70  70  0   93  0   0   0   0   92  0   0   0   0   0   0   0   0   0   0   0   0   0   0   0   0   0   0   0   0   0   0   0   0   0   0   0   0   0   0   0   0   0   0   0   0   0   0   0   0   98  99  100 0   0   0   0   0   0   0   0   0   0   0   0   0   0   0   0   0   0   0   0   0   0   0   0   0   0   0   73  0   0   0   0   77  77  78  77  77  0   0   0   0   0   0   0   0   0   0   0   0   0   0 
0   0   0   0   0   0   0   0   0   0   0   0   0   0   0   0   0   0   0   0   0   93  0   0   0   0   0   0   0   0   0   0   0   93  0   0   0   0   0   0   0   93  0   0   0   0   0   0   70  0   0   0   0   0   0   0   0   0   0   0   0   0   0   0   0   0   0   98  99  100 0   93  0   0   0   0   93  0   0   0   0   0   0   0   0   0   0   0   0   0   0   0   0   0   0   0   70  0   0   0   0   0   0   0   0   0   0   0   0   0   0   0   0   0   0   0   0   0   92  0   0   0   0   0   0   0   0   0   0   0   0   0   0   0   0   0   0   0   0   0   0   0   0   0   0   0   0   73  0   0   83  83  82  82  82  82  82  83  83  83  83  83  83  83  83  83  83  83  83  83  83
0   83  83  83  0   0   0   0   0   0   0   0   0   0   0   0   0   0   0   0   0   93  0   0   70  70  70  70  70  0   0   0   0   93  0   0   0   0   0   0   0   93  0   0   0   0   0   0   0   0   0   98  99  100 0   0   0   0   0   0   0   0   0   0   0   0   0   0   92  0   0   93  0   70  0   0   93  0   0   0   0   0   0   0   0   0   0   0   0   0   0   0   0   0   0   0   0   0   0   0   0   0   0   0   0   0   0   0   0   0   0   0   0   70  70  70  70  70  93  0   0   0   0   0   0   0   0   0   0   0   0   0   0   0   0   0   0   0   0   0   0   0   0   0   0   0   0   73  0   0   77  77  77  79  77  79  77  77  77  77  77  77  77  77  77  77  77  77  77  77  77
0   80  77  81  0   0   0   0   0   0   0   0   0   0   0   0   0   0   0   0   0   93  0   98  99  99  99  99  99  100 0   0   0   93  0   0   0   0   0   0   0   93  0   0   98  99  100 0   0   0   0   0   92  0   0   0   0   0   0   0   0   0   0   0   0   0   0   0   93  0   0   93  98  99  100 0   93  0   0   0   0   0   0   0   98  99  100 0   0   0   0   0   0   0   0   0   0   0   0   0   0   0   0   0   0   0   0   0   0   0   0   0   0   98  99  99  99  100 93  0   0   0   0   0   0   0   0   0   0   0   0   0   0   0   0   0   0   0   0   0   0   0   0   0   0   0   0   73  0   0   77  77  77  78  77  78  77  77  77  77  77  77  77  77  77  77  77  77  77  77  77
83  82  82  82  83  0   0   0   0   0   0   0   0   0   0   0   0   0   0   0   0   93  0   0   0   0   92  0   0   0   0   0   0   93  0   0   0   0   0   0   0   93  0   0   0   92  0   0   0   0   0   0   93  0   0   0   0   0   0   0   0   0   0   0   0   0   0   0   93  0   0   93  0   92  0   0   93  0   0   0   0   0   0   0   0   92  0   0   0   0   0   0   0   0   0   0   0   0   0   0   0   0   0   0   0   98  99  100 0   0   0   0   0   0   0   92  0   0   93  0   0   0   0   0   0   0   0   0   0   0   98  99  99  99  100 0   0   0   0   0   0   0   0   0   0   0   0   73  0   0   77  77  77  77  77  77  77  77  77  77  77  77  77  77  77  77  77  77  77  77  77
77  77  78  77  77  0   0   0   0   0   0   0   0   0   0   0   0   0   0   0   0   93  0   0   0   0   93  0   0   0   0   0   0   93  0   0   0   0   70  70  70  93  0   0   0   93  0   0   0   0   0   0   93  0   0   0   0   0   0   0   0   0   0   0   0   0   0   0   93  0   0   93  0   93  0   0   93  0   0   0   0   0   0   0   0   93  0   0   0   0   0   0   0   0   0   0   0   0   0   98  99  100 0   0   0   0   92  0   0   0   0   0   0   0   0   93  0   0   93  0   0   0   0   0   0   0   0   0   0   0   0   0   92  0   0   0   0   0   0   0   0   0   0   0   0   0   0   73  0   0   77  77  79  77  79  77  79  77  77  77  77  77  77  77  77  77  77  77  77  77  77
77  77  78  77  77  0   0   0   0   0   0   0   0   0   0   0   0   0   0   0   0   93  0   0   0   0   93  0   0   0   0   0   0   93  0   0   98  99  99  99  99  99  100 0   0   93  0   0   0   0   0   0   93  0   0   0   0   0   0   0   0   0   0   0   0   0   0   0   93  0   0   93  0   93  0   0   93  0   0   0   0   0   0   0   0   93  0   0   0   0   0   0   0   0   0   0   0   0   0   0   92  0   0   0   0   0   93  0   0   0   0   0   0   0   0   93  0   0   93  0   0   0   0   0   0   0   0   0   0   0   0   0   93  0   0   0   0   0   0   0   0   0   0   0   0   0   0   7   0   0   77  77  78  77  78  77  78  77  77  77  77  77  77  77  77  77  77  77  77  77  77
1   1   1   1   1   1   1   1   1   1   1   1   1   1   1   0   98  99  99  99  100 93  0   0   0   0   93  0   0   0   0   0   0   93  0   0   0   0   0   92  0   93  0   0   0   93  0   0   0   0   0   0   93  0   0   0   0   0   0   0   0   0   0   0   0   98  99  99  99  100 0   93  0   93  0   0   93  0   0   0   0   0   0   0   0   93  0   0   0   0   0   0   0   0   0   0   0   0   0   0   93  0   0   0   0   0   93  0   0   0   0   0   0   0   0   93  0   0   93  0   0   98  99  99  99  99  99  100 0   0   0   0   93  0   0   0   0   0   0   0   0   1   1   1   1   1   1   1   1   1   1   1   1   1   1   1   1   1   1   1   1   1   1   1   1   1   1   1   1   1   1 
1   1   1   1   1   1   1   1   1   1   1   1   1   1   1   0   0   0   92  0   0   93  0   0   0   0   93  0   0   0   0   0   0   93  0   0   0   0   0   93  0   93  0   0   0   93  0   0   0   0   0   0   93  0   0   0   0   0   0   0   0   0   0   0   0   0   0   92  93  0   0   93  0   93  0   0   93  0   0   0   0   0   0   0   0   93  0   0   0   0   0   0   0   0   0   0   0   0   0   0   93  0   0   0   0   0   93  0   0   0   0   0   0   0   0   93  0   0   93  0   0   0   0   0   92  0   0   0   0   0   0   0   93  0   0   0   0   0   0   0   0   1   1   1   1   1   1   1   1   1   1   1   1   1   1   1   1   1   1   1   1   1   1   1   1   1   1   1   1   1   1 