0   0   0   0   0   0   0   0   0   0   0   0   0   0   0   0   0   0   0   0   0   0   0   0   0   0   0   0   0   0   0   0   0   0   0   0   0   0   0   0   0   0   0   0   0   0   0   0   0   0   0   0   0   0   0   0   0   0   0   0   0   0   0   0   0   0   0   0   0   0   0   0   0   0   0   0   0   0   0   0   0   0   0   0   0   0   0   0   0   0   0   0   0   0   0   0   0   0   0   0   0   0   0   0   0   0   0   0   0   0   0   0   0   0   0   0   0   0   0   0   0   0   0   0   0   0   0   0   0   0   0   0   0   0   0   0   0   0   0   0   0   0   0   0   0   0   0   0   0   0   0   0   0   0   0   0   0   0   0   0   0   0   0   0   0   0   0   0   0   0   0   0   0   0   0   0   0   0   0   0   0   0   0   0   0   0   0   0   0   0   0   0   0   0   0   0   0   0   0   0
0   0   0   0   0   0   0   0   0   0   0   0   0   0   0   0   0   0   0   0   0   0   0   0   0   0   0   0   0   0   0   0   0   0   0   0   0   0   0   0   0   0   0   0   0   0   0   0   0   0   0   0   0   0   0   0   0   0   0   0   0   0   0   0   0   0   0   0   0   0   0   0   0   0   0   0   0   0   0   0   0   0   0   0   0   0   0   0   0   0   0   0   0   0   0   0   0   0   0   0   0   0   0   0   0   0   0   0   0   0   0   0   0   0   0   0   0   0   0   0   0   0   0   0   0   0   0   0   0   0   0   0   0   0   0   0   0   0   0   0   0   0   0   0   0   0   0   0   0   0   0   0   0   0   0   0   0   0   0   0   0   0   0   0   0   0   0   0   0   0   0   0   0   0   0   0   0   0   0   0   0   0   0   0   0   0   0   0   0   0   0   0   0   0   0   0   0   0   0   0
0   0   0   0   0   0   0   0   0   0   0   0   0   0   0   0   0   0   0   0   0   0   0   0   0   0   0   0   70  70  0   0   0   0   0   0   0   0   0   0   0   0   0   0   0   0   0   0   0   0   0   0   0   0   0   0   0   0   0   0   0   0   0   0   0   0   0   0   0   0   0   123 125 125 125 124 0   0   0   123 125 125 124 0   0   70  70  70  0   0   0   0   0   0   0   0   0   0   0   0   0   0   0   0   0   0   0   0   0   0   0   0   0   0   0   0   0   0   0   0   0   0   0   0   0   0   0   123 125 125 124 0   0   0   0   0   0   0   0   0   0   0   0   0   0   0   0   0   0   0   0   0   0   0   0   0   0   0   0   0   0   0   0   0   0   0   0   76  0   0   0   0   0   90  90  90  0   0   0   0   0   0   0   0   0   0   0   0   0   0   0   0   0   0   0   0   0   0   0   0
0   0   0   0   0   0   0   0   0   0   0   0   0   0   0   0   0   0   0   0   0   0   0   0   0   0   0   0   0   0   0   0   0   0   0   0   0   0   0   0   0   0   0   0   0   0   0   0   0   0   0   0   0   0   0   13  0   0   0   0   0   0   0   0   0   0   0   0   0   0   0   0   0   0   0   0   0   0   0   0   0   0   0   0   0   101 102 103 0   0   0   0   0   0   0   0   0   0   0   0   0   0   0   0   0   0   0   0   0   0   0   0   0   0   0   0   0   0   0   0   0   0   0   0   0   0   0   0   0   0   0   0   0   0   0   0   0   0   0   0   0   0   0   0   0   0   0   0   0   0   0   0   0   0   70  70  0   0   0   0   0   0   0   0   0   0   0   75  0   0   0   0   0   87  84  88  0   0   0   0   0   0   0   0   0   0   0   0   0   0   0   0   0   0   0   0   0   0   0   0
0   0   0   0   0   0   0   0   0   0   0   0   0   0   0   0   0   0   0   0   0   0   0   0   0   0   0   0   0   0   0   0   0   0   0   0   0   0   0   0   0   0   0   70  70  70  70  70  70  70  0   0   0   0   0   0   0   0   0   0   0   0   0   0   0   0   0   0   0   0   0   0   0   0   0   0   0   0   0   0   0   0   0   0   0   0   94  0   0   0   0   0   0   0   0   0   0   0   0   0   0   0   0   0   0   0   0   0   0   0   0   0   0   0   0   0   0   0   0   0   0   0   0   0   0   0   0   0   0   0   0   0   0   0   0   0   0   0   0   0   0   0   0   0   0   0   0   0   0   0   0   0   0   0   0   0   0   0   0   0   0   0   0   0   0   0   0   75  0   0   0   0   90  89  89  89  90  0   0   0   0   0   0   0   0   0   0   0   0   0   0   0   0   0   0   0   0   0   0   0
0   0   0   0   0   0   0   0   0   0   0   0   0   0   0   0   0   0   0   0   0   0   0   0   0   0   0   0   0   0   0   0   0   0   0   0   0   0   0   0   0   0   0   0   0   0   0   0   0   0   0   0   0   0   0   0   0   0   0   0   0   0   0   0   0   0   0   0   0   0   0   0   0   70  70  0   0   0   0   0   0   0   0   0   0   0   94  0   0   0   0   0   0   0   0   0   0   0   0   0   0   0   0   0   0   0   0   0   0   0   0   0   0   0   0   0   0   0   0   0   0   0   0   0   0   0   0   0   70  70  0   0   101 102 103 0   0   0   0   0   0   0   0   0   0   0   0   0   0   0   0   0   0   0   0   0   101 102 103 0   0   0   0   0   0   0   0   75  0   0   0   0   84  84  86  84  84  0   0   0   0   0   0   0   0   0   0   0   0   0   0   0   0   0   0   0   0   0   0   0
0   0   0   0   0   0   0   0   0   0   0   0   0   0   0   0   0   0   0   0   0   0   0   0   0   0   0   0   0   0   0   0   0   0   0   0   0   0   0   0   0   0   0   0   0   0   0   0   0   0   0   0   0   0   0   0   0   0   0   0   0   0   0   0   0   0   0   0   0   0   0   0   0   0   0   0   0   0   0   0   0   0   0   0   0   0   94  0   0   0   0   0   0   0   0   0   0   0   0   0   0   0   0   0   0   0   0   0   0   0   0   0   0   0   0   0   0   0   0   0   0   0   0   0   0   0   0   0   0   0   0   0   0   94  0   0   0   0   0   0   0   0   0   0   0   0   0   0   0   0   0   0   0   0   0   0   0   94  0   0   0   0   0   0   0   0   0   75  0   0   0   0   84  84  85  84  84  0   0   0   0   0   0   0   0   0   0   0   0   0   0   0   0   0   0   0   0   0   0   0
0   0   0   0   0   0   0   0   0   0   0   0   0   0   0   0   0   0   0   0   0   0   0   0   0   0   0   0   0   0   0   0   0   0   0   0   0   0   0   0   0   0   0   0   0   0   0   0   0   0   0   0   0   0   0   0   0   0   0   0   0   0   0   0   0   0   0   0   0   0   0   0   0   0   0   0   0   0   0   0   0   0   0   0   0   0   94  0   0   0   0   0   0   0   0   0   0   0   0   0   0   0   0   0   0   0   0   0   0   0   0   0   0   0   0   0   0   0   0   0   0   0   0   0   0   0   0   0   0   0   0   0   0   94  0   0   0   0   0   0   0   0   0   0   0   70  70  0   0   0   0   0   0   0   0   0   0   94  0   0   0   0   0   0   0   0   0   75  0   0   90  90  89  89  89  89  89  90  90  90  90  90  90  90  90  90  90  90  90  90  0   0   0   0   0   0   0   0   0   0
0   90  90  90  0   0   0   0   0   0   0   0   0   0   0   0   0   0   0   0   0   0   0   0   0   0   0   0   0   0   0   0   0   0   0   0   0   0   0   0   0   0   0   0   0   0   0   0   0   0   0   0   0   0   0   0   0   0   0   0   0   0   0   0   0   0   0   0   0   0   0   0   0   0   0   0   0   0   0   0   0   0   0   0   0   0   94  0   0   0   101 102 103 0   0   0   0   0   0   0   70  70  70  70  0   0   0   0   0   0   0   0   0   0   0   0   0   0   0   0   0   0   0   0   0   0   0   0   0   0   0   0   0   94  0   0   0   0   0   0   0   0   0   0   0   0   0   0   0   0   0   0   0   0   0   0   0   94  0   0   0   0   0   0   0   0   0   75  0   0   84  84  84  86  84  86  84  84  84  84  84  84  84  84  84  84  84  84  84  84  0   0   0   0   0   0   0   0   0   0
0   87  84  88  0   0   0   0   0   0   0   0   0   0   0   0   0   0   0   0   0   101 102 103 0   0   0   0   0   0   0   101 102 102 103 0   0   0   0   0   0   0   0   0   0   0   0   0   0   0   0   0   0   0   0   0   0   0   0   0   0   0   0   0   0   101 102 102 102 103 0   0   0   0   0   0   0   0   0   0   0   0   0   0   0   0   94  0   0   0   0   94  0   0   0   0   0   0   0   0   0   0   0   0   0   0   0   101 102 102 102 103 0   0   0   0   0   0   0   0   0   0   0   0   0   0   0   0   0   0   0   0   0   94  0   101 102 102 103 0   0   0   0   0   0   0   0   0   0   0   0   0   0   0   0   0   0   94  0   0   0   0   0   0   0   0   0   75  0   0   84  84  84  85  84  85  84  84  84  84  84  84  84  84  84  84  84  84  84  84  0   0   0   0   0   0   0   0   0   0
90  89  89  89  90  0   0   0   0   0   0   0   0   0   0   0   0   0   0   0   0   0   94  0   0   0   0   0   0   0   0   0   94  94  0   0   0   0   0   0   0   0   0   0   0   0   0   0   0   0   0   0   0   0   0   0   0   0   0   0   0   0   0   0   0   0   94  94  94  0   0   0   0   0   0   0   0   0   0   0   0   0   0   0   0   101 102 102 102 103 0   94  0   0   0   0   0   0   0   0   0   0   0   0   0   0   0   0   94  94  94  0   0   0   0   0   0   0   0   0   0   0   0   0   0   0   0   0   0   0   0   0   0   94  0   0   94  94  0   0   0   0   0   0   0   0   0   0   0   0   0   0   0   0   0   0   0   94  0   0   0   0   0   0   0   0   0   75  0   0   84  84  84  84  84  84  84  84  84  84  84  84  84  84  84  84  84  84  84  84  0   0   0   0   0   0   0   0   0   0
84  84  85  84  84  0   0   0   0   0   0   0   0   0   0   0   0   0   0   0   0   0   94  0   0   0   0   0   0   0   0   0   94  94  0   0   0   0   0   0   0   0   0   0   0   0   0   0   0   101 102 102 103 0   0   0   0   0   0   0   0   0   0   0   0   0   94  94  94  0   0   0   0   0   0   0   0   0   0   0   0   0   0   0   0   0   94  94  94  0   0   94  0   0   0   0   0   0   0   0   0   0   0   0   0   0   0   0   94  94  94  0   0   0   0   0   0   0   0   0   0   0   0   0   0   0   0   0   0   0   0   0   0   94  0   0   94  94  0   0   0   0   0   0   0   0   0   0   0   0   0   0   0   0   0   0   0   94  0   0   0   0   0   0   0   0   0   75  0   0   84  84  86  84  86  84  86  84  84  84  84  84  84  84  84  84  84  84  84  84  0   0   0   0   0   0   0   0   0   0
84  84  85  84  84  0   0   0   0   0   0   0   0   0   0   0   0   0   0   0   0   0   94  0   0   0   0   0   0   0   0   0   94  94  0   0   0   0   0   0   0   0   0   0   0   0   0   0   0   0   94  94  0   0   0   0   0   0   0   0   0   0   0   0   0   0   94  94  94  0   0   0   0   0   0   0   0   0   0   0   0   0   0   0   0   0   94  94  94  0   0   94  0   0   0   0   0   0   0   0   0   0   0   0   0   0   0   0   94  94  94  0   0   0   0   0   0   0   0   0   0   0   0   0   0   0   0   0   0   0   0   0   0   94  0   0   94  94  0   0   0   0   0   0   0   0   0   0   0   0   0   0   0   0   0   0   0   94  0   0   0   0   0   0   0   0   0   9   0   0   84  84  85  84  85  84  85  84  84  84  84  84  84  84  84  84  84  84  84  84  0   0   0   0   0   0   0   0   0   0
4   4   4   4   4   4   4   4   4   4   4   4   4   4   4   4   0   0   101 102 103 0   94  0   101 102 103 0   0   0   0   0   94  94  0   0   0   101 102 103 0   0   0   101 102 103 0   0   0   0   94  94  0   0   0   0   0   0   0   0   0   0   0   0   0   0   94  94  94  0   0   0   0   0   0   0   0   0   0   0   0   0   0   0   0   0   94  94  94  0   0   94  0   101 102 103 0   101 102 102 103 0   0   101 102 103 0   0   94  94  94  0   0   101 102 102 102 103 0   0   0   0   0   101 102 103 0   0   0   0   0   0   101 102 102 103 94  94  0   0   0   0   0   0   0   0   0   0   0   0   0   0   0   0   0   0   0   94  0   0   4   4   4   4   4   4   4   4   4   4   4   4   4   4   4   4   4   4   4   4   4   4   4   4   4   4   4   4   4   4   0   0   0   0   0   0   0   0   0   0
4   4   4   4   4   4   4   4   4   4   4   4   4   4   4   4   0   0   0   94  0   0   94  0   0   94  0   0   0   0   0   0   94  94  0   0   0   0   94  0   0   0   0   0   94  0   0   0   0   0   94  94  0   0   0   0   0   0   0   0   0   0   0   0   0   0   94  94  94  0   0   0   0   0   0   0   0   0   0   0   0   0   0   0   0   0   94  94  94  0   0   94  0   0   94  0   0   0   94  94  0   0   0   0   94  0   0   0   94  94  94  0   0   0   94  94  94  0   0   0   0   0   0   0   94  0   0   0   0   0   0   0   0   94  94  0   94  94  0   0   0   0   0   0   0   0   0   0   0   0   0   0   0   0   0   0   0   94  0   0   4   4   4   4   4   4   4   4   4   4   4   4   4   4   4   4   4   4   4   4   4   4   4   4   4   4   4   4   4   4   0   0   0   0   0   0   0   0   0   0